####################
#P.................#
#......####........#
#......#..#.....D..#
#......#..#........#
#.D....####.D..M...#
####################