####################
#P............D....#
#......####........#
#......#D.#........#
#......#..#..D..D..#
#......####....M...#
####################